+------------------------------------------------------------------------------+
|                                                                              |
|                                                                              |
|                                                                              |
+------------------------------------------------------------------------------+
+------------------++----------------------------------------------------------+
|                  ||                                                          |
|                  ||                                                          |
|                  ||                                                          |
|                  ||                                                          |
|                  ||                                                          |
|                  ||                                                          |
|                  ||                                                          |
|                  ||                                                          |
|                  ||                                                          |
|                  ||                                                          |
|                  ||                                                          |
|                  ||                                                          |
|                  ||                                                          |
|                  ||                                                          |
|                  ||                                                          |
|                  ||                                                          |
|                  ||                                                          |
|                  ||                                                          |
|                  ||                                                          |
+------------------++----------------------------------------------------------+
+------------------------------------------------------------------------------+
|                                                                              |
|                                                                              |
|                                                                              |
+------------------------------------------------------------------------------+